OOOOOOOOOOOOOOOOOOOOOOOOOOOOOOOOOOOOOOOOOOOOOO
OXOO    O   OOO    O    O         O   OOOO . O
O OO OO O O OOO OO . OO O OOOOOOO O O .  O O O
O     O O O  .  OOOOOOO O O   .   O O OO O O O
OOOOO O . OOOOOOOO . OO O O OOOOOOO O OO O O O
O . O OOOOOOOOOOOO O OO O O O   O   O OO O O O
O O O O .       OO O  O . O O.O O OOO OO   O O
O O O O OOOOOOO.OO OO OOOOO O O O O     OOOO O
O O O O O   .   OO OO  OOOO   O O O OOOOO  . O
O O O O O OOOOOOOO OOO OOOOOOOO O O O   O OOOO
O O O O O    .     OOO O   O    . O O O O    O
O O O O OOOOOOOOOOOOOO O O O OO OOO   O OOOO O
O O O O O    .       O O O OOOOOOOOOOOO    O.O
O O . O O OOOOOOOOOO.O.O O   O       OOOOO O O
O OOOOO O O OO . O   O O OOO O OOOOO O   O O O
O O .   O O  O O O  OO O   O O     O O O O   O
O O O OOO OO O O O OOO OOO O OOOOO O O O OOOOO
O . O   . OO   O   OOO     O  .    O   O .   U
OOOOOOOOOOOOOOOOOOOOOOOOOOOOOOOOOOOOOOOOOOOOOO